  __  __                 _____                             
 |  \/  |               |  __ \                 BY GROUP 10
 | \  / | __ _ _______  | |__) |   _ _ __  _ __   ___ _ __ 
 | |\/| |/ _` |_  / _ \ |  _  / | | | '_ \| '_ \ / _ \ '__|
 | |  | | (_| |/ /  __/ | | \ \ |_| | | | | | | |  __/ |   
 |_|  |_|\__,_/___\___| |_|  \_\__,_|_| |_|_| |_|\___|_|   
                                                           
 ==========================================================                                            
 > Press 1 for Player Mode          > Press 2 for Auto Mode