  	   _      ____   ____   _____ ______ _____  
	  | |    / __ \ / __ \ / ____|  ____|  __ \ 
	  | |   | |  | | |  | | (___ | |__  | |__) |
	  | |   | |  | | |  | |\___ \|  __| |  _  / 
	  | |___| |__| | |__| |____) | |____| | \ \ 
	  |______\____/ \____/|_____/|______|_|  \_\
	  ==========================================
	  Sorry !!! You're looser....