 # # # # # # # # # # # # # # # # # # # # # # # # # # # # # # # 
 #                                                           # 
 #   # #   # # # #   # # # #   # # # #   # # # # #   # # #   # 
 #   # #   # # # #   # # # #   # # # #   # # # # #   # # #   # 
 #   # #   # # # #   # # # #   # # # #   # # # # #   # # #   # 
 #   # #                                     # # #           # 
 #   # # # # # # # # # #   # # # # # # # #   # # #   # # #   # 
 #   # # # # # # # # # #   # # # # # # # #                   # 
 #   # #                           # # # #   # # #   # # #   # 
 #   # #   # # # # # # #   # # #   # # # #   # # #   # # #   # 
 #   # #   # # # # # # #   # # #             # # #   # # #   # 
 #   # #   # # # # # # # # # # #   # # # #   # # #           # 
 #   # #   # #       # # # # # #   # # # #   # # #   # # #   # 
 #         # #   +                 # # # #   # # #   # # #   # 
 #   # #   # #       # # # #   # # # # # # # # # #   # # #   # 
 #   # #   # # # # # # # # #                                 # 
 #   # #   # # # # # # # # #   # # # # # # # # # # # # # #   # 
 #                                                           # 
 # # # # # # # # # # # # # # # # # # # # # # # # # # # # # # # 
