	______ _________________ _____ _____ _____   _ _ _ 
	| ___ \  ___| ___ \  ___|  ___/  __ \_   _| | | | |
	| |_/ / |__ | |_/ / |_  | |__ | /  \/ | |   | | | |
	|  __/|  __||    /|  _| |  __|| |     | |   | | | |
	| |   | |___| |\ \| |   | |___| \__/\ | |   |_|_|_|
	\_|   \____/\_| \_\_|   \____/ \____/ \_/   (_|_|_)
	===================================================
	CONGRATULATION !!! YOU ARE THE WINNER..............